 - - - - - - - - - - - 
| . . . . . . . . . . |
| . . . . . S . . . . |
| . . . . . . . . . . |
| . . . . . X . . . . |
| . . X X X X X X . . |
| . . . . . . . . . . |
| . . . . . . X X X X |
| X X X X . . . . . . |
| . F . . . . . . . . |
| . . . . . . . . . . |
 - - - - - - - - - - - 
