 - - - - - - - - - - - 
| . . . . . . . . . . |
| . . . . . . . X . . |
| . . . . . . . . . . |
| . . . . . . . F . . |
| . . . X . . X . . . |
| . S X . . . X . . . |
| . . X . . . . . X . |
| . . . . . . . . . . |
| . . X . . . X . X . |
| . . . . . . . . . . |
 - - - - - - - - - - - 
