 - - - - - - - - - - - 
| . . . . . . . . . . |
| . . . . . . X . . . |
| . . . . . . X . . . |
| . . . X X X X . . . |
| . . . . . . X . . . |
| . . . . . . X . . . |
| . . . . . . X . . . |
| . S . . X . . F . . |
| . . . . X . . . . . |
| . . . . X . . . . . |
 - - - - - - - - - - - 
