 - - - - - - - - - - - 
| . . . . . . . . . . |
| . . X . . X . . . . |
| . . X . . X . . . . |
| . . X . . X . . . . |
| . . . . . . F . . . |
| . . . . . X . . . . |
| . . . . . X . . . . |
| . . . . . X . . . . |
| . X X X . . . . . . |
| . . . . S . . . . . |
 - - - - - - - - - - - 
